111111111111111111111
1P0000C000000C00000E1
101111011111111110101
100000010C00000010001
111101011111101110101
100001000010000000C01
101111011C11111110101
100000010000000010001
111101011111101110101
100001000010000000001
101111011111111110101
1000000C0000000000001
111101011111101110101
100001000010000000001
101111011011111110101
100000C100000000C0001
111101011111101110101
100001000010000000001
101111011011111110101
111111111111111111111