1111111111111111111111111111111111111111111
1111111111110000000000000000011111111111111
1111111111000000000000000000000111111111111
1111111110000000000000000000000011111111111
1111111100000000000000000000000001111111111
1111111000000000111111111100000000111111111
1111110000000011111111111111000000011111111
1111100000000111111111111111100000001111111
1111000000001111111111111111110000000111111
1110000000011111111111111111111000000011111
1100000000011111111111111111111100000001111
1000000000011111111111111111111110000000111
1000000000111111111111111111111111000000011
1000000001111111111000001111111111100000001
1000000011111111110000000111111111110000001
1000000111111111100000000011111111111000001
1000001111111111000000000001111111111100001
1000011111111110000000000000111111111110001
1000111111111100000000000000011111111111001
1001111111111000000000000000001111111111101
101111111111000000000000C000000111111111111
1111111111100000000000000000000011111111111
1111111111000000000000000000000001111111111
1111111110000000000000000000000000111111111
1111111100000000000000000000000000011111111
1111111000000000000000000000000000001111111
1111110000000000000000000000000000000111111
111110000000000000000000P000000000001111111
1111000000000000000000000000000000000001111
1110000000000000000000000000000000000000111
1100000000000000000000000000000000000000011
1000000000000000000000000000000000000000E01
1111111111111111111111111111111111111111111